1111111111111111111
100P0000000000C0001
1000000011100000001
100000001C000000001
1000C000000000E0001
1111111111111111111
