1111111111111111111
100P000000000000001
100000001110000C001
111110001C000000001
1000C000000000E0001
1111111111111111111
