11111111111111111111
100P0P0000000000C001
10000000000000000001
10000000000C0000E001
11111111111111111111
